#############################
#---------------------------#
#---------------------------#
#-------#############-------#
#-------#############-------#
#-------#############-------#
#-------#############-------#
#---------------------------#
#-------#####---#####-------#
#-------#####---#####-------#
#---------------------------#
#-------#############-------#
#---------------------------#
#############################